NO ./textures/wall_01.xpm
SO ./textures/wall_03.xpm
WE ./textures/wall_02.xpm
EA ./textures/wall_04.xpm

F 224,172,105

C 205,249,255

111111
100101
101001
1100E1
111111
