NO ./textures/Wall_0.xpm
SO ./textures/Wall_0.xpm
WE ./textures/Wall_0.xpm
EA ./textures/Wall_0.xpm

F 186,222,255

C 255,222,186

1111111111111111111111111
1000000000110000000000001
1011000001110000000000001
100100000000000000000000111111111
111111111011000001110000000000001
100000000011000001110111111111111
1111011111111101000000100011
1111011111111111101010010001
110000001101010111000000100011
10011100000000001100000000001
1001 100000000001101010010001
1101110111010101111101111S00111
11110111 1110101 101111010001
11111111 1111111 111111111111
